GGGGGGGGGGGGGGGGGGGG
G                  G
G                  G
G               GG G
G                 GG
G                  G
G           GG    GG
G     P            G
G                  G
GG    G           GG
GGGGGGGGGGGGGGGGGGGG